      ########
      ##  ####
      #..$  .#
      # #$ $ #
      #@  #  #
      #####  #
      ########