##########
#.  $$  .#
#$       #
#$    $$ #
#     $$ #
#. @    *#
##########