      ###############
      #@ #  .  #    #
      # $..$ # $..* #
      # $.#$## #$.$ #
      # $..$ $ .$ .##
      #.*#.$ #$$..$ #
      #             #
      ###############